{
    "level1": [
        0,3,3,3,3,3,3,3,3,3,3,3,3,3,0,
        0,0,6,1,6,1,6,1,6,1,6,1,6,0,0,
        0,0,4,0,4,0,4,0,4,0,4,0,4,0,0,
        0,0,0,5,0,1,0,1,0,1,0,5,0,0,0,
        0,0,5,0,1,0,1,0,1,0,1,0,5,0,0,
        0,5,7,1,1,1,1,1,1,1,1,1,7,5,0
    ],
    "level2": [
        0,0,1,1,1,1,1,1,1,1,1,1,1,0,0,
        0,1,1,1,1,1,1,1,1,1,1,1,1,1,0,
        0,1,1,1,0,0,1,1,1,0,0,1,1,1,0,
        1,1,1,1,0,0,1,1,1,0,0,1,1,1,1,
        1,1,1,1,1,1,1,1,1,1,1,1,1,1,1,
        1,1,1,1,1,1,1,1,1,1,1,1,1,1,1,
        1,1,1,1,1,1,1,1,1,1,1,1,1,1,1,
        0,1,1,1,1,1,1,1,1,1,1,1,1,1,0,
        0,1,2,2,2,2,2,2,2,2,2,2,2,1,0,
        0,0,1,1,1,1,1,1,1,1,1,1,1,0,0,
        0,0,0,1,1,1,1,1,1,1,1,1,0,0,0
    ],
    "level3": [
        0,0,1,1,1,1,1,1,1,1,1,1,1,0,0,
        0,1,1,1,1,1,1,1,1,1,1,1,1,1,0,
        0,1,1,1,0,0,1,1,1,0,0,1,1,1,0,
        1,1,1,1,0,0,1,1,1,0,0,1,1,1,1,
        1,1,1,1,1,1,1,1,1,1,1,1,1,1,1,
        1,1,1,1,1,1,1,1,1,1,1,1,1,1,1,
        1,1,1,1,1,1,1,1,1,1,1,1,1,1,1,
        0,1,1,1,1,1,1,1,1,1,1,1,1,1,0,
        0,1,2,2,2,2,2,2,2,2,2,2,2,1,0,
        0,0,1,1,1,1,1,1,1,1,1,1,1,0,0,
        0,0,0,1,1,1,1,1,1,1,1,1,0,0,0
    ]
}